#######################
#..........#..........#
#.## #####.#.#### ###.#
#o#......#.#.#......#o#
#.#.####.#.#.#.####.#.#
#.#.#.##.#.#.#.#.##.#.#
#.#....#.#.#.#.#....#.#
#.## ###.#.#.#.## ###.#
#........# = #........#
###########%###########
#          =          #
##################### #
#...................#.#
#.#################.#.#
#.#...............#.#.#
#.#.####### #####.#.#.#
#o#.#......\......#.#o#
#.#.###############.#.#
#.#.................#.#
#.######### #########.#
#.....................#
#######################