#######################
#..........#..........#
#.########.#.########.#
#o#......#.#.#......#o#
#.#.####.#.#.#.####.#.#
#.#.#.##.#.#.#.#.##.#.#
#.#....#.#.#.#.#....#.#
#.######.#.#.#.######.#
#........# = #........#
###########%###########
#          =          #
##################### #
#...................#.#
#.#################.#.#
#.#...............#.#.#
#.#.#############.#.#.#
#o#.#......\......#.#o#
#.#.###############.#.#
#.#.................#.#
#.###################.#
#.....................#
#######################