#######################
#..........#..........#
#.## #####.#.#### ###.#
#o ......#.#.#...... o#
#.#.####.#.#.#.####.#.#
#.#.#.##.#.#.#.#.##.#.#
#.#....#.#.#.#.#....#.#
#.## ###. .#. .## ###.#
#........# = #........#
###########%###########
#          =          #
#### ################ #
#...................#.#
#.########### #####.#.#
#.#............... .#.#
#. .## ##########.#.#.#
#o#.#......\......#.#o#
#.#.############ ##. .#
#.#.................#.#
#.###### ############.#
#.....................#
#######################